1234####4321
#1234##4321#
##12344321##
###123321###
####1221####
####1111####
####1111####
####1221####
###123321###
##12344321##
#1234**4321#
1234****4321
