***444444***
**44444444**
**44####44**
**44####44**
**33333333**
**33333333**
111111111111
111111111111
11********11
##********##
************
************
