#4334##4334#
143341143341
143341143341
143341143341
122221122221
122221122221
122221122221
122221122221
143341143341
143341143341
143341143341
#4334##4334#
