############
#4444444444#
#4222222224#
#4222222224#
#4211111124#
#4211111124#
#4211111124#
#4211111124#
#4211111124#
#4211111124#
#1111111111#
#1111111111#
