#1314212141#
113142123411
123242123421
123242123421
143242123441
#4224212324#
141111111141
141111111141
122242123241
123242123421
113142123421
#1314242141#
