*123333321**
*1233#3321**
*1244#4421**
*124444421**
*124444421**
*124444421**
*124444421**
*124444421**
*1244#4421**
*1244#4421**
*123333321**
*123333321**
